#################################################
#........###..........................#.........#
#........#.#....##..........##........#.........#
#........#......##..........##........#.........#
#........#............................#.........#
#........#............................#.........#
#........#......##..........##........#.........#
#........#......##..........##........#.........#
#s.......#..................##........#.........#
#@..............................................#
#........#..................##........#.........#
#........#......##..........##........#.........#
#........#......##..........##........#.........#
#........#............................#.........#
#........#............................#.........#
#........#......##..........##........#.........#
#........#.#....##..........##........#.........#
#........###..........................#.........#
#################################################